41 41
13 37
25 37
19 1
1 1
37 1
77777777777777777777777777777777777777777
70000000000004440000000004440000000000007
70000000000004440000000004440000000000007
70000000000004440000000004440000000000007
70002222222224440000000000000000000000007
70002222222224440000000000000000000000007
70002222222224440000000000000008888888887
74442222222224440000000000000000000000007
74442222222224440000000000000000000000007
74442222222224440000000000000000000000007
72222222222224440000004440004444444444007
72222222222224440000004440004444444444007
72222222222224440000004440004444444444007
72222222222224444444444440004440000440007
72222222222224444444440000004440000440007
72222222222224444444440000004440000440007
72222222222220000004440000000000000440007
72222222222220000004440000000000000440007
72222222222220000004440000000000000440007
70002220000000000008888888880000002220007
70002220000000000008888888880000002220007
70002220000000000008888888880000002220007
70000000000000000000000000002222222222227
70000000000000000000000000002222222222227
70004440004440000000000000002222222222227
74444400044444000000000000002222222222227
74444400044444000444444444442222222222227
74444400044444000440000000002222222222227
70000000000000004440000000002222222222227
70000000000000004440004444442222222222227
70000000000000004440004444442222222222227
74440000008800000000004444442222222220007
74440000008800000000000000002222222220007
74440000008800000000000000002222222220007
74444440008800000000000000002222222220007
74444440008800000044444440002222222220007
74444440008800000044444440002222222220007
78884444440000000041111140004440000000007
78884444440000000041151140004440000000007
78884444440000000041111140004440000000007
77777777777777777777777777777777777777777