43 41
13 37
25 37
19 1
1 1
37 1
7777777777777777777777777777777777777777777
7000222222000000000000000000000000002220007
7000222222000000000000000000000000002220007
7000222222000000000000000000000000002220007
7222222000000000444444000000000000000002227
7222222000000444444444000000000000000002227
7222222000000444444444444444000000000002227
7222000000044444444444444444000000000008887
7222000000044444444444444444444440000000007
7222000000044444444444444444444444440000007
7888000000444444444444444444444444444400007
7000000000444444444444444444444444444400007
7000000000444444444444444444444440004400007
7000000044444000000000444444444440004400007
7000000044444000000000444444444440004400007
7000000044000000000000000444444000000000007
7999000044000880000880000444444000000000007
7999000044000880000880000444444000000000007
7999000044000880000880000444444000009999997
7000000444000000000000000444444000009999997
7000000444000444444000000444444000009999997
7000000444000444444000000444444440000000007
7000000444444444444444444444444440000000007
7000000444444444444444444444444440000000007
7000000444444444444444444444444444400000007
7000044444444444444444444444444444400000007
7000044444444444444444444444444444400000007
7000044444444444444444444444444444440000007
7000444444444444444444444444444444440000007
7000444444444444444444444444444444440000007
7000000000444444444444444444000000000000007
7000444444000444444444444000444444440002227
7000444444444000444444000444444444440002227
7000444444444000444444000444444444440002227
7222000444444000000000000444444000002222227
7222000444444000044444440444444000002222227
7222000000000000044444440000000000002222227
7888222000000000041111140000000002222228887
7888222000000000041151140000000002222228887
7888222000000000041111140000000002222228887
7777777777777777777777777777777777777777777