44 41
13 37
25 37
19 1
1 1
37 1
77777777777777777777777777777777777777777777
70000000000004444440000000000000000000000007
70000000000004444440000000000000000000000007
70000000000004444440000000000000000000000007
70000000000004440000000000008888888880000007
78880004440004440000000000008888888880000007
78880004440004440000000000000000008880000007
78880004440000000004440000000000000000000007
78880004440000000004440000000000000000000007
78880004440000000004440000000000000000000007
74440004444444440004444440000009999990009997
74440004444444440004444440000009999990009997
74440004444444440004444440000009999990009997
74440000000004440000000000000009990000000007
70000000000000000000000000000009990000000007
70000000000000000000000000000009990000000007
70000000000009999990009999999999990004444447
70000000000009999990009999999999990004444447
70000004440009999990009999999999990004444447
74444440000009994440004444400000000000000007
74444440000009994440004444400000000000000007
74444440000009994440004444400000000000000007
70000000000009990000000000000000888000000007
70000000000009990000000000000000888000000007
70000000000009990000000000000000888000000007
79999999990009990008880004440000880000000007
79999999990009990008880004440000880000000007
79999999990009990008880004440000880000000007
70000000000000000000000000000000884444444447
70000000004444440000000000000000884444444447
70000000004444440000000000000000884444444447
70000000000004444444444444440000000000000007
70000000000004444444444444444440000000000007
70000000000004440000000004444444440000000007
74444444440000000000000000004444440000000007
74444444440000000444444400000004440000000007
74444440000000000444444400000000000000000007
74440000000000000411111400000000000000000007
74440000000000000411511400000000000000000007
70000000000000000411111400000000000000000007
77777777777777777777777777777777777777777777

