41 38
13 34
25 34
19 1
1 1
37 1
77777777777777777777777777777777777777777
70000000000000000000000000000000000000007
70000000000000000000000000000000000000007
70000000000000000000000000000000000000007
70004440004440004440004440004440004440007
70004440004440004440004440004440004440007
70004440004440004440004440004440004440007
70004440004440004440004440004440004440007
70004440004440004440004440004440004440007
70004440004440004448884440004440004440007
70004440004440004448884440004440004440007
70004440004440004448884440004440004440007
70004440004440004440004440004440004440007
70004440004440000000000000004440004440007
70004440004440000000000000004440004440007
70004440004440000000000000004440004440007
70000000000000004440004440000000000000007
70000000000000004440004440000000000000007
70000000000000004440004440000000000000007
74440004444440000000000000004444440004447
74440004444440000000000000004444440004447
78880004444440000000000000004444440008887
70000000000000004440004440000000000000007
70000000000000004444444440000000000000007
70000000000000004444444440000000000000007
70004440004440004440004440004440004440007
70004440004440004440004440004440004440007
70004440004440004440004440004440004440007
70004440004440000000000000004440004440007
70004440004440000000000000004440004440007
70004440004440000000000000004440004440007
70004440004440000000000000004440004440007
70004440004440004444444440004440004440007
70004440004440004444444440004440004440007
70000000000000004411111440000000000000007
70000000000000004411511440000000000000007
70000000000000004411111440000000000000007
77777777777777777777777777777777777777777