41 41
13 37
25 37
19 1
1 1
37 1
77777777777777777777777777777777777777777
70000000008880000000008880000000000000007
70000000008880000000008880000000000000007
70000000008880000000008880000000000000007
70004440008880000000004440004440004440007
70004440008880000000004440004440004440007
70004440008880000000004440004440004440007
70004440000000000004444440004448884440007
70004440000000000004444440004448884440007
70004440000000000004444440004448884440007
70000000004440000000000000008880000000007
70000000004440000000000000008880000000007
70000000004440000000000000008880000000007
72220000004440000008880000004442224448887
72220000004440000008880000004442224448887
72220000004440000008880000004442224448887
72222220000000004440000008880002220000007
72222220000000004440000008880002220000007
72222220000000004440000008880002220000007
70004444444442222222228880000002224440007
70004444444442222222228880000002224440007
70004444444442222222228880000002224440007
70000000008882224440004440004440004440007
70000000008882224440004440004440004440007
70000000008882224440004440004440004440007
78884440008880004440004440000000004440007
78884440008880004440004440000000004440007
78884440008880004440004440000000004440007
70004440004440004444444440004448884440007
70004440004440004444444440004448884440007
70004440004440004444444440004448884440007
70004440004440004444444440000000000000007
70004440004440004444444440000000000000007
70004440004440004444444440000000000000007
70004440000000000000000000004440004440007
70004440000000004444444440004440004440007
70004440000000004444444440004440004440007
70004440004440004411111440004444444440007
70004440004440004411511440004444444440007
70004440004440004411111440004444444440007
77777777777777777777777777777777777777777